0 0 0 0 0 0 0 0 0 0 0 0 0 0 0 0 0 0 0 0 0 0 0 0 0 0 0 0 0 1
0 0 1 1 1 1 0 0 0 0 1 1 0 1 0 0 1 0 1 0 0 1 0 1 0 1 0 0 1 1
0 0 1 1 1 2 2 2 2 2 2 2 2 1 0 1 0 1 0 1 0 1 0 1 2 2 2 0 0 0
0 0 1 1 2 2 2 2 2 3 3 3 3 3 2 2 2 2 2 2 2 2 2 2 3 2 2 1 0 0
0 0 1 0 1 1 2 3 3 3 5 5 5 3 3 3 3 3 3 3 3 3 3 3 3 3 2 2 2 1
0 1 1 1 2 2 3 3 5 5 5 5 5 5 5 5 5 5 5 5 5 5 3 3 3 5 2 0 0 1
0 0 0 0 1 1 2 3 3 3 5 5 5 4 4 4 4 4 4 4 3 3 3 3 3 2 1 1 0 0
0 0 0 0 0 1 1 2 3 3 5 5 5 4 4 4 4 4 3 3 5 5 5 5 3 2 1 1 1 0
0 1 1 1 0 0 2 3 3 3 5 5 5 4 4 4 4 5 5 5 5 3 3 3 3 2 1 0 1 0
0 0 0 0 0 0 2 3 3 5 5 5 5 5 5 5 5 5 3 3 3 3 3 3 2 0 0 0 0 0
0 1 1 1 0 2 2 3 3 3 5 5 3 3 5 5 5 5 3 5 3 3 3 3 2 1 1 0 1 0
0 1 1 1 0 2 2 2 2 3 3 5 5 5 3 5 5 5 5 5 5 3 3 3 3 2 1 1 1 1
0 0 0 0 0 1 1 0 2 2 2 3 3 3 5 5 5 5 3 3 5 5 3 3 2 1 0 0 0 1
0 0 1 0 1 2 2 2 2 3 3 3 3 5 5 5 5 5 5 5 3 5 3 3 2 0 1 0 1 1
0 1 0 2 2 3 3 3 3 3 5 5 5 5 5 5 5 5 5 3 3 3 3 2 1 0 1 0 1 1
0 1 0 2 2 3 3 3 3 5 5 5 5 5 5 5 5 5 5 5 5 3 3 3 2 2 1 0 0 0
0 0 1 0 2 2 3 3 3 3 3 5 5 4 4 4 4 4 4 5 5 5 5 5 3 3 2 0 0 0
0 0 0 1 0 1 2 3 3 3 5 4 4 4 4 4 4 5 5 5 5 5 5 3 2 0 1 0 1 0
0 0 1 0 1 1 1 2 2 2 3 3 3 5 4 4 4 5 5 5 5 5 3 3 2 1 0 1 0 0
0 1 0 2 2 3 3 3 5 5 4 4 4 4 4 4 4 5 5 5 5 5 5 5 5 3 2 1 1 1
0 1 0 1 0 2 2 3 3 3 3 5 5 4 4 4 4 5 5 5 5 5 3 3 3 2 0 0 1 1
0 0 2 2 2 3 3 3 3 3 3 5 4 4 4 4 4 5 5 5 5 5 5 3 3 3 2 1 1 0
0 1 0 1 1 2 2 2 3 3 3 3 5 5 4 4 4 4 4 5 5 3 3 3 3 2 2 0 0 1
0 0 1 1 2 2 2 2 3 3 3 3 5 5 5 4 4 4 4 5 5 5 3 2 2 2 0 1 0 0
0 1 1 0 1 0 2 3 3 3 3 3 5 5 5 5 5 4 4 4 5 5 3 2 0 1 1 0 0 1
0 0 0 2 2 2 3 3 3 3 5 5 5 5 5 5 5 5 5 5 3 5 3 3 2 2 1 0 1 0
0 1 1 0 2 3 3 3 3 3 3 3 5 5 5 5 3 3 3 2 2 2 2 2 3 2 1 0 1 1
0 0 1 0 2 2 2 2 3 3 3 3 3 3 2 2 2 2 2 1 0 1 0 1 2 2 0 0 1 0
0 0 1 1 1 0 1 0 1 2 2 2 2 2 0 1 0 1 1 0 1 0 1 0 1 0 0 1 0 1
0 0 0 0 0 0 0 0 0 0 0 0 0 0 0 0 0 0 0 0 0 0 0 0 0 0 0 0 0 0