1 1 1 1 1 1 1 1 1 1 1 1 1 1 1 1 1 1 1 1 1 1 1 1 1 1 1 1 1 1 1 1 1 1 1 1 1 1 1 1 1 1 1 1 1 1 1 1 1 1 1 1 1 1 1 1 1 1 1 1
1 1 1 1 1 1 1 1 1 1 1 1 1 1 1 1 1 1 1 1 1 1 1 1 1 1 1 1 1 1 1 1 1 1 1 1 1 1 1 1 1 1 1 1 1 1 1 1 1 1 1 1 1 1 1 1 1 1 1 1
1 1 1 1 1 1 1 1 1 1 1 1 1 1 1 1 1 1 1 1 1 1 1 1 1 1 1 1 1 1 1 1 1 1 1 1 1 1 1 1 1 1 1 1 1 1 1 1 1 1 1 1 1 1 1 1 1 1 1 1
1 1 1 0 0 0 0 0 0 0 0 0 0 0 0 0 0 0 0 0 0 0 0 1 1 1 1 1 1 1 1 1 1 1 1 1 1 1 4 4 4 4 4 1 1 1 1 1 1 1 1 1 1 0 0 0 0 0 0 1
1 1 1 0 0 0 0 0 0 0 0 0 0 0 0 0 0 0 0 1 1 0 0 1 1 1 1 1 1 1 1 1 1 1 1 1 1 4 4 2 2 2 2 4 1 1 1 1 1 1 1 1 1 1 0 0 0 1 0 1
1 1 1 0 0 0 0 0 0 0 0 0 0 0 0 0 0 0 0 0 1 1 1 1 1 1 1 1 1 4 4 4 4 1 1 1 4 4 4 2 2 2 2 4 1 1 1 1 1 1 1 1 1 1 0 0 0 1 1 1
1 1 1 0 0 0 0 0 0 0 0 0 0 0 0 1 1 1 0 0 1 1 1 1 1 1 1 1 4 6 6 4 4 4 4 4 4 4 2 2 2 2 2 4 1 1 1 1 1 1 1 1 1 1 1 1 1 1 1 1
1 1 1 0 0 0 0 0 0 0 0 0 1 1 1 1 1 1 1 1 1 1 1 1 1 1 1 4 4 4 4 4 5 5 5 5 5 4 4 5 5 4 2 4 1 1 1 1 1 1 1 1 1 1 1 1 1 1 0 1
1 1 1 0 0 0 0 0 0 0 0 0 0 1 1 1 1 1 1 1 1 1 1 1 1 1 1 4 4 4 4 4 5 2 5 5 5 4 5 5 5 4 5 4 4 1 1 1 1 1 1 1 1 1 1 1 1 1 0 1
1 1 1 0 0 0 0 1 1 1 1 1 1 1 1 1 1 1 1 1 1 1 1 1 1 1 4 4 4 4 4 4 5 5 5 4 4 4 4 5 5 5 5 5 4 4 4 1 1 1 1 1 1 1 1 1 1 1 1 1
1 1 1 0 0 0 0 1 1 1 1 1 1 1 1 1 1 1 1 1 1 1 1 1 1 4 4 4 4 4 4 4 5 5 4 4 4 4 5 5 5 5 5 5 4 1 4 1 1 1 1 1 1 1 1 1 1 1 1 1
1 1 1 1 1 1 1 1 1 1 1 1 1 1 1 1 1 1 1 1 1 1 1 1 4 4 4 4 4 4 4 5 5 5 5 5 5 5 5 5 5 5 5 2 4 4 4 1 1 1 1 1 1 1 1 1 1 1 1 1
1 1 1 1 1 1 1 1 1 1 1 1 1 1 1 1 1 1 1 1 1 1 4 4 4 4 2 4 6 4 5 5 5 5 5 5 5 5 5 5 5 5 5 5 2 6 5 4 4 4 4 4 1 1 1 1 1 1 1 1
1 1 1 1 1 1 1 1 1 1 1 1 1 1 1 1 1 1 1 1 4 4 2 2 4 4 4 6 2 5 5 5 5 5 5 5 5 5 5 5 5 5 5 5 5 5 5 2 2 2 2 4 1 1 1 1 1 1 1 1
1 1 1 1 1 1 1 1 1 1 1 1 1 1 1 1 1 1 4 4 4 4 2 2 4 4 4 4 4 5 5 5 5 5 5 5 5 5 5 5 5 4 4 5 5 5 5 2 2 2 2 4 1 1 1 1 1 1 1 1
1 1 1 1 1 1 1 1 1 1 1 1 1 1 1 4 4 2 2 2 2 2 4 4 4 4 4 4 4 5 5 5 5 5 5 5 5 5 4 5 4 4 4 5 5 5 4 4 2 2 2 4 1 1 1 1 1 1 1 1
1 1 1 1 1 1 1 1 1 1 1 1 1 1 1 4 4 5 5 4 4 4 4 4 4 4 4 4 4 5 5 5 5 5 5 5 4 4 4 4 4 4 4 5 5 5 5 4 4 2 2 4 1 1 1 1 1 1 1 1
1 1 1 1 1 1 1 1 1 1 1 1 1 1 1 4 2 5 4 4 4 4 4 4 4 4 4 4 4 4 4 5 5 5 5 5 4 4 4 4 4 4 4 5 5 5 5 5 4 4 4 4 1 1 1 1 1 1 1 1
1 1 1 1 1 1 1 1 1 1 1 1 4 4 4 4 2 4 4 4 4 4 4 4 4 4 4 4 4 4 5 5 5 5 4 5 4 4 4 4 4 4 4 5 5 5 5 5 5 6 4 1 1 1 1 1 1 1 1 1
1 1 1 1 1 1 1 1 1 1 1 4 2 2 2 2 4 4 4 4 4 5 5 5 5 5 5 5 5 5 5 5 5 5 5 4 4 4 4 5 5 4 4 5 5 5 5 5 5 6 6 4 1 1 1 1 1 1 1 1
1 1 1 1 1 1 1 1 1 1 4 2 5 2 2 2 4 5 5 5 5 5 5 5 5 5 5 5 5 4 4 5 5 4 4 4 5 5 5 4 4 5 4 4 5 5 5 5 5 4 4 4 4 1 1 1 1 1 1 1
1 1 1 1 1 1 1 1 1 1 2 4 4 5 5 5 4 4 4 5 5 5 5 5 5 5 5 5 5 4 4 5 5 4 5 5 5 4 4 4 4 4 4 4 5 5 5 5 5 4 4 4 4 1 1 1 1 1 1 1
1 1 1 1 1 1 1 1 1 4 4 4 4 5 5 5 4 5 4 5 5 5 5 4 4 4 4 4 4 4 4 5 4 4 5 4 4 4 4 4 4 4 4 5 5 5 5 5 5 5 2 4 4 1 1 1 1 1 1 1
1 1 1 1 1 1 1 1 4 4 5 5 5 5 5 4 4 4 4 4 4 4 4 4 5 4 4 4 4 4 4 4 4 4 4 5 4 4 4 4 4 4 4 5 4 4 5 5 5 5 5 5 4 1 1 1 1 1 1 1
1 1 1 1 1 1 1 4 4 4 5 5 5 5 5 4 4 4 4 4 4 4 4 4 4 4 4 4 4 4 4 4 4 4 4 4 5 5 5 4 4 4 4 4 4 4 5 5 5 5 5 5 4 1 1 1 1 1 1 1
1 1 1 1 1 1 1 4 4 2 5 5 5 5 5 4 4 4 4 4 4 4 4 4 4 4 4 4 4 4 4 4 4 4 4 4 4 5 5 4 4 4 4 4 4 4 5 5 5 5 5 4 4 1 1 1 1 1 1 1
1 1 1 1 1 1 1 4 4 5 5 5 5 5 4 4 4 4 4 4 4 4 4 4 4 4 4 4 4 4 4 4 4 4 5 5 5 5 5 5 4 5 5 4 4 4 5 5 5 5 5 4 1 1 1 1 1 1 1 1
1 1 1 1 1 1 2 2 5 5 5 5 5 4 4 4 4 4 4 4 4 5 6 4 4 4 4 4 4 4 4 4 5 5 5 4 4 4 4 4 4 5 4 4 4 4 5 5 5 4 4 4 1 1 1 1 1 1 1 1
1 1 1 1 1 4 2 2 5 5 5 5 5 5 4 4 4 4 4 4 4 4 6 5 5 5 4 5 4 4 5 4 4 5 5 4 4 4 4 5 5 4 4 4 4 5 5 5 5 4 4 1 1 1 1 1 1 1 1 1
1 1 1 1 1 4 2 2 5 5 5 5 5 5 4 4 4 4 4 4 4 4 4 4 4 4 4 4 4 4 5 5 4 5 5 5 5 5 5 5 5 4 4 4 5 5 5 5 5 2 2 4 4 1 1 1 1 0 0 1
1 1 1 1 1 4 2 2 5 5 5 5 5 5 5 4 4 4 4 4 4 4 4 4 4 4 4 4 4 5 5 5 5 5 5 5 5 5 5 5 5 5 5 5 5 5 5 5 4 4 5 6 4 1 1 1 0 0 0 1
1 1 1 1 1 4 2 2 4 4 5 5 5 5 5 4 4 4 4 4 4 4 4 4 4 4 4 4 4 5 5 4 4 4 4 4 4 4 4 4 4 4 4 4 5 5 5 6 4 5 5 6 4 1 1 1 0 0 0 1
1 1 1 1 1 4 2 2 2 5 5 5 5 5 4 4 4 4 5 5 5 5 5 5 5 5 5 4 4 5 5 5 4 4 4 4 4 4 4 4 4 4 4 4 5 5 5 4 5 2 2 4 1 1 1 1 0 0 0 1
1 1 1 1 1 1 1 2 2 4 4 5 5 5 4 4 4 4 4 4 5 5 5 5 4 5 5 5 5 5 5 5 5 5 4 4 4 4 4 5 4 5 4 5 5 5 5 4 2 2 4 1 1 1 1 1 0 0 0 1
1 1 1 1 1 1 1 2 2 4 4 5 5 5 4 4 4 4 4 4 4 4 5 5 5 5 5 5 5 5 5 5 5 5 4 4 4 4 4 6 5 4 4 5 5 4 4 4 2 2 1 1 1 1 1 1 1 1 0 1
1 1 1 1 1 1 4 2 2 2 5 5 5 5 5 4 4 4 4 4 4 4 4 4 4 4 4 5 5 5 5 5 5 4 4 4 4 4 6 6 4 4 5 5 5 5 2 2 2 4 1 1 1 1 1 1 1 1 0 1
1 1 1 1 1 4 2 2 6 2 4 4 5 5 5 4 4 4 4 4 4 4 4 4 4 4 4 4 4 4 4 4 4 4 4 5 4 4 6 4 4 4 4 6 4 4 4 4 4 1 1 1 1 1 1 1 1 0 0 1
1 1 1 1 1 4 4 6 6 4 4 4 4 4 4 5 5 5 4 4 4 4 4 4 4 4 4 4 4 4 4 4 4 4 4 5 4 4 6 4 4 4 4 4 1 1 1 1 1 1 1 1 1 1 1 1 1 0 0 1
1 1 1 1 1 1 1 1 6 6 5 4 4 4 4 4 4 4 4 4 4 4 4 4 4 4 4 4 4 4 4 4 4 5 4 4 5 5 4 4 4 4 5 4 4 1 1 1 1 1 1 1 1 1 1 1 1 1 0 1
1 1 1 1 1 1 1 1 4 2 2 5 4 4 4 4 4 4 5 5 4 5 5 5 4 5 5 5 5 4 4 4 5 5 4 4 5 4 5 5 4 4 4 2 2 4 1 1 1 1 1 1 1 1 1 1 1 1 0 1
1 1 1 1 1 1 1 1 1 2 2 2 4 4 4 4 4 5 5 5 5 5 4 4 4 4 5 5 5 5 5 5 5 5 5 4 4 4 5 5 4 4 5 2 4 5 4 1 1 1 1 1 1 1 1 1 1 1 0 1
1 1 1 1 1 1 1 1 1 2 4 4 4 4 4 4 4 4 4 4 4 4 4 4 4 4 4 5 5 5 5 5 5 5 5 5 4 4 5 4 5 4 4 4 4 4 5 1 1 1 1 1 1 1 1 1 1 0 0 1
1 1 1 1 1 1 1 1 1 4 4 4 5 2 2 2 4 4 4 4 4 4 4 4 4 4 4 4 4 5 5 5 5 5 4 5 5 5 5 4 5 4 4 5 5 5 5 1 1 1 1 1 1 1 1 1 1 0 0 1
1 1 1 1 1 1 1 1 1 4 4 4 4 4 2 2 2 4 4 4 4 4 4 4 5 5 4 4 4 4 5 5 5 5 5 5 5 4 4 4 4 5 5 2 2 4 4 1 1 1 1 1 1 1 1 1 1 0 0 1
1 1 1 0 0 0 1 1 1 1 1 1 1 1 4 2 2 5 4 4 4 4 5 4 4 5 5 4 4 4 5 5 5 5 5 4 4 4 4 4 4 2 5 4 2 4 1 1 1 1 1 1 1 1 1 1 0 0 0 1
1 1 1 0 0 1 1 1 1 1 1 1 1 1 1 2 4 4 4 5 4 4 4 4 4 5 4 4 4 4 4 5 5 5 5 4 4 4 4 4 4 2 5 4 4 1 1 1 1 1 1 1 1 1 1 1 0 0 0 1
1 1 1 0 0 1 1 1 1 1 1 1 1 1 1 4 4 4 2 5 4 4 4 4 4 4 4 6 4 4 4 5 5 5 5 4 5 4 4 4 4 4 4 4 1 1 1 1 1 1 1 1 1 1 1 1 0 0 0 1
1 1 1 0 0 0 1 1 1 1 1 1 1 1 1 4 4 4 2 2 4 4 4 4 4 5 6 6 4 4 4 5 5 4 5 5 5 4 4 4 4 4 1 1 1 1 1 1 1 1 1 1 1 1 1 1 0 0 0 1
1 1 1 0 0 0 0 1 1 1 1 1 1 1 1 1 1 4 2 2 2 4 4 4 4 4 6 6 4 4 4 4 5 4 5 4 4 4 4 4 4 4 1 1 1 1 1 1 1 1 1 1 1 1 1 1 0 0 0 1
1 1 1 0 0 0 0 0 1 1 1 1 1 1 1 1 1 1 2 2 5 4 4 4 4 4 4 4 4 4 4 4 5 5 4 4 4 4 4 5 4 2 1 1 1 1 1 1 1 1 1 1 1 1 1 1 0 0 0 1
1 1 1 0 0 0 0 0 1 1 1 1 1 1 1 1 1 1 1 2 4 4 4 4 4 4 4 4 4 4 4 4 5 4 4 4 4 4 4 4 2 2 1 1 1 1 1 1 1 1 1 1 1 1 1 1 1 1 0 1
1 1 1 0 0 0 0 0 1 1 1 1 1 1 1 1 1 1 1 1 4 4 4 4 4 4 4 4 4 4 4 4 4 4 4 4 4 4 4 4 4 2 1 1 1 1 1 1 1 1 1 1 1 1 1 1 1 1 1 1
1 1 1 0 0 0 0 0 1 1 1 1 1 1 1 1 1 1 1 1 1 4 4 2 4 4 4 4 5 5 5 5 4 4 4 4 4 4 4 4 4 4 1 1 1 1 1 1 1 1 1 1 1 1 1 1 1 1 1 1
1 1 1 0 0 0 0 0 0 0 1 1 1 1 1 1 1 1 1 1 1 1 4 4 2 2 2 2 2 2 2 2 5 5 4 4 4 4 4 4 5 4 1 1 1 1 1 1 1 1 1 1 1 1 1 1 1 1 1 1
1 1 1 0 0 0 0 0 0 0 0 0 1 1 1 1 1 1 1 1 1 1 1 1 4 4 4 4 4 4 4 4 4 4 4 4 4 4 4 2 2 4 1 1 1 1 1 1 1 1 1 1 1 1 1 1 1 1 1 1
1 1 1 0 0 0 0 0 0 0 0 0 1 1 1 1 1 1 1 1 1 1 1 1 1 1 1 1 1 1 1 1 1 1 1 1 4 4 4 2 4 1 1 1 1 1 1 1 1 1 1 1 1 1 1 1 1 1 1 1
1 1 1 0 0 0 0 0 0 0 0 0 1 1 1 1 1 1 1 1 1 1 1 1 1 1 1 1 1 1 1 1 1 1 1 1 4 4 4 2 1 1 1 1 1 1 1 1 1 1 1 1 1 1 1 1 1 0 0 1
1 1 1 0 0 0 0 0 0 0 0 0 0 0 0 1 1 1 1 1 1 1 1 1 1 1 1 1 1 1 1 1 1 1 1 1 1 1 4 2 1 1 1 1 1 1 1 1 1 1 1 1 1 1 1 1 0 0 0 1
1 1 1 0 0 0 0 0 0 0 0 0 0 0 0 0 1 1 1 1 1 1 1 1 1 1 1 1 1 1 1 1 1 1 1 1 1 1 1 1 1 1 1 1 1 1 1 1 1 1 1 1 1 0 0 0 0 0 0 1
1 1 1 1 1 1 1 1 1 1 1 1 1 1 1 1 1 1 1 1 1 1 1 1 1 1 1 1 1 1 1 1 1 1 1 1 1 1 1 1 1 1 1 1 1 1 1 1 1 1 1 4 4 1 1 1 1 1 1 1